3 3 3 3 3 3 3
3 9 1 33 1 9 3
3 1 3 3 3 1 3
3 1 1 5 1 1 3
3 1 1 17 1 1 3
3 9 1 1 1 9 3
3 3 3 3 3 3 3