3 3 3 3 3 3 3
3 33 1 1 3 3 3
3 1 1 1 3 3 3
3 1 1 1 1 1 3
3 3 3 1 17 1 3
3 3 3 1 1 1 3
3 3 3 3 3 3 3