3 3 3 3 3 3 3
3 1 5 1 5 1 3
3 3 3 1 5 1 3
3 3 3 1 3 1 3
3 3 17 1 3 1 3
3 3 1 1 1 33 3
3 3 3 3 3 3 3