3 3 3 3 3 3 3 3 3 3 3 3 3 3
3 17 1 5 5 5 3 3 17 1 5 5 5 3
3 9 3 9 3 1 9 1 1 9 9 1 1 3
3 5 1 9 1 9 1 1 9 33 1 3 3 3
3 1 1 9 1 1 3 5 1 1 17 1 5 3
3 3 1 1 3 3 3 3 1 1 9 1 1 3
3 17 1 5 5 5 3 3 17 1 5 5 5 3
3 9 3 9 3 1 9 1 1 9 9 1 1 3
3 1 1 9 1 1 3 5 3 3 17 1 5 3
3 3 1 1 3 3 3 3 1 1 9 1 1 3
3 1 1 9 1 1 3 5 3 3 17 1 5 3
3 1 1 9 1 1 3 5 3 3 17 1 5 3
3 9 3 9 3 1 9 1 1 9 9 1 1 3
3 3 3 3 3 3 3 3 3 3 3 3 3 3