3 3 3 3 3 3 3
3 3 3 1 17 9 3
3 3 3 3 3 1 3
3 1 1 33 1 9 3
3 1 5 5 5 1 3
3 3 1 1 1 3 3
3 3 3 3 3 3 3